####B###############
####  ##############
###     ############
######   ###########
########  ##########
########          ##
###############   ##
############     ###
##############   ###
############    ####
#########     ######
#######    #########
########   #########
#########  #########
#######   ##########
#####   ############
#####   ############
####   #############
####  ##############
####A###############